а = a, @
б = 6, b
в = b, v
г = r, g
д = d, g
е = е, e
ё = е, e
ж = zh
з = 3, z
и = u, i
і = i, 1
й = u, y, i
к = k, i{, |{
л = l, ji
м = м, m
н = h, n
о = o, 0
п = n, p
р = r, p
с = c, s
т = m, t
у = y, u
ф = f, ph
х = x, h, к, k, }{
ц = c, u
ч = ch
ш = ш, sh
щ = щ, sch
ь = ь, b
ы = bi
ъ = ъ
э = е, e
ю = io, u, yu
я = ya, ia